3333333333333333333333333333333333333333333333333333333333333333333333333333333333333333333333333333
3----------------------------------------2---2---2---2---------------------------------------------3
3----------------------------------------2---2---2---2---222222222---------------------------------3
3--------------------------------00------2---2---2---2---------------------------------------------3
3---------------------------0-----00---------2-------2---------------2-----------------------------3
3--------------2-----------00--0--00-----------------2---------------2-----------------------------3
3------2---2---2-------0-0000-00-0000----2-------2-------0---0---0---2--06660----------------------3
3---2--2---2---2------000000000000000----2---2---2-------------------2--0-0-0---22-----0-----2-----3
3---2--2---2---2-----0000000000000000----2---2---2---2---------------2----0------------0----------73
3333333366636663333333333333333333333333333333333333333333663366333363333333333666633333366666633333