3333333333333333333333333333333333333333333333333333333333333333333333333333333333333333333333333333
3----------------------------------------2---2---2---2---------------------------------------------3
3----------------------------------------2---2---2---2---222222222---------------------------------3
3--------------------------------00------2---2---2---2---------------------------------------------3
3---------------------------0-----00---------2-------2---------------2-----------------------------3
3--------------2-----------00--0--00-----------------2---------------2-----------------------------3
3------2---2---2-------0-0000-00-0000----2-------2-------0---0---0---2--00600----------------------3
3---2--2---2---2------000000000000000----2---2---2-------------------2--0-0-0----------0-----2-----3
3---2--2---2---2-----0000000000000000----2---2---2---2---------------2----0-----22-----0----------73
3333333366636663333333333333333333333333333333333333333333363336333333333333333333333333366666633333